WWWWWWWWWWWWWWWWWWWW
W  P               W
W     WWWWWWWWWWWWWW
W         E        W
W                  W
W     WWWWWWWWWWWWWW
W          W       W
W       W          W
WWWWWWWWWWWWWW     W
W       E          W
W           W      W
W     WWWWWWWWWWWWWW
W      W           W
W              E  TW
WWWWWWWWWWWWWWWWWWWW